2
0 0
12 14
0 0 0 0 0 0 0 0 0 0 0 0 0 0
0 0 0 0 0 0 0 0 0 0 0 0 0 0
0 0 0 0 0 0 0 0 0 0 0 0 0 0
0 0 2 0 2 0 3 3 0 2 0 2 0 0
0 0 2 0 2 0 3 3 0 2 0 2 0 0
0 0 2 0 2 0 3 3 0 2 0 2 0 0
0 0 2 0 2 0 3 3 0 2 0 2 0 0
0 0 2 0 2 0 3 3 0 2 0 2 0 0
0 0 2 0 2 0 3 3 0 2 0 2 0 0
0 0 1 1 1 1 1 1 1 1 1 1 0 0
0 0 1 1 1 1 1 1 1 1 1 1 0 0
0 0 1 1 1 1 1 1 1 1 1 1 0 0

4 0

775 0

0 0

356 556
0 0
4

390 400
0 -1
3
