1
0 0
10 10
5 5 5 5 5 5 5 5 5 5
1 1 1 1 0 0 1 1 1 1
2 2 2 0 0 0 0 2 2 2
3 3 0 0 0 0 0 0 3 3
4 0 0 0 0 0 0 0 0 4
0 0 0 0 0 0 0 0 0 0
4 0 0 0 0 0 0 0 0 4
3 3 0 0 0 0 0 0 3 3
2 2 2 0 0 0 0 2 2 2
1 1 1 1 0 0 1 1 1 1

4 0

775 0

0 0

356 556
0 0
4

390 400
0 -1
3