1
0 0
10 10
5 5 5 5 0 5 5 5 5 5 
1 1 1 1 0 0 1 1 1 1 
2 2 2 0 0 0 0 2 2 2 
3 3 0 0 0 0 0 0 3 3 
4 0 0 0 0 0 0 0 0 4 
0 0 0 0 0 0 0 0 0 0 
4 0 0 0 0 0 0 0 0 4 
3 3 0 0 0 0 0 0 3 3 
2 2 2 0 0 0 0 2 2 2 
1 1 1 0 0 0 1 1 1 1 

4 0

775 0

0 0

376 556
0 0
4

343.994 209.887
0.251398 -0.967884
3

1
370 323
0 1
-842150451
