1
0 0
10 10
5 5 0 0 0 0 0 0 0 0 
1 0 0 0 0 0 0 0 0 0 
2 0 0 0 0 0 0 0 0 0 
3 0 0 0 0 0 0 0 0 0 
4 0 0 0 0 0 0 0 0 0 
0 0 0 0 0 0 0 0 0 0 
0 0 0 0 0 0 0 0 0 0 
3 0 0 0 0 0 0 0 0 0 
2 0 0 0 0 0 0 0 0 0 
1 1 0 0 0 0 0 0 0 0 

4 0

775 0

0 0

412 556
0 0
4

420.25 432.257
0.3041 0.95264
3

2
102 478
0 1
1
E
196 469
0 1
1
S
